0 0 0 0 0 0 0 0 0 0 0 0 0 0 0 0 0
10 11 12 12 12 12 12 12 12 12 12 12 12 12 12 22 21
13 14 1 1 1 1 1 1 1 1 1 1 1 1 1 24 23
13 15 1 2 1 2 1 2 1 2 1 2 1 2 1 25 23
13 15 1 1 1 1 1 1 1 1 1 1 1 1 1 25 23
13 15 1 2 1 2 1 2 1 2 1 2 1 2 1 25 23
13 15 1 1 1 1 1 1 1 1 1 1 1 1 1 25 23
13 15 1 2 1 2 1 2 1 2 1 2 1 2 1 25 23
13 15 1 1 1 1 1 1 1 1 1 1 1 1 1 25 23
13 15 1 2 1 2 1 2 1 2 1 2 1 2 1 25 23
16 17 1 1 1 1 1 1 1 1 1 1 1 1 1 27 26
18 19 20 20 20 20 20 20 20 20 20 20 20 20 20 29 28
