0 0 0 0 0 0 0 0 0 0 0 0 0 0 0 0 0
10 2 2 2 2 2 2 2 2 2 2 2 2 2 2 2 10
10 2 1 1 1 1 1 1 1 1 1 1 1 1 1 2 10
10 2 1 2 1 2 1 2 1 2 1 2 1 2 1 2 10
10 2 1 1 1 1 1 1 1 1 1 1 1 1 1 2 10
10 2 1 2 1 2 1 2 1 2 1 2 1 2 1 2 10
10 2 1 1 1 1 1 1 1 1 1 1 1 1 1 2 10
10 2 1 2 1 2 1 2 1 2 1 2 1 2 1 2 10
10 2 1 1 1 1 1 1 1 1 1 1 1 1 1 2 10
10 2 1 2 1 2 1 2 1 2 1 2 1 2 1 2 10
10 2 1 1 1 1 1 1 1 1 1 1 1 1 1 2 10
10 2 2 2 2 2 2 2 2 2 2 2 2 2 2 2 10

